########################################################
#......................................................#
#......................................................#
#......................................................#
#......................................................#
#...................................#..................#
#.....#####.........................#..................#
#...................................#..................#
#.......S...........................#####..............#
#.......................................#..............#
#..........F............................#..............#
#......................................................#
#......................................................#
#......................................................#
########################################################
