################################################################
#..............................................................#
#..........######..............................................#
#.........................................###....#.............#
#..............................................................#
#.........................................#....................#
#..........######.........................########.............#
#..............................................................#
#......................########....#...........................#
#......................#...........#...........................#
#......................#...........#...........................#
#......................#...........#.............#...#.........#
#......................#....########.............#...#.........#
#................................................#...#.........#
#..............................................................#
#.....#....#...................................................#
#.....#....#................S..................................#
#.....#....#...................................................#
#..............................................................#
#..............................................................#
#..............................................#.....#.........#
#......................######..................#..F..#.........#
#..............................................#.....#.........#
#..............................................................#
#..............................................................#
#......................######..................................#
#..............................................................#
################################################################
